------------------
--AR--VBV--I---D--
-U--Q-M--K-J--GH--
-T----L--C-D---H--
-U-SB-Q--L-J---E--
-T--R-P--P-K---G--
--ASF-NMN--C--IFE-
------------------