------------------
--AR--VBV--I---D--
-U--Q-M--K-J--GE--
-T----L--C-D---E--
-U-SB-Q--L-J---H--
-T--R-P--P-K---G--
--ASF-NMN--C--IFH-
------------------