----N----
---LHL---
--IFDGI--
-KFEBEGK-
NHDBABDHN
-KGEBEFK-
--IGDFI--
---LHL---
----N----
---MAM---